5,-175,0,120,0,0,0,,// 左端崖
6,-175,0,90,0,0,0,,
7,-175,0,60,0,0,0,,
8,-175,0,30,0,0,0,,
9,-175,0,10,0,0,0,,
5,-175,0,-20,0,0,0,,
6,-175,0,-50,0,0,0,,
7,-175,0,-80,0,0,0,,
8,-175,0,-110,0,0,0,,
9,-175,0,-130,0,0,0,,
5,175,0,120,0,0,0,,// 右端崖
6,175,0,90,0,0,0,,
7,175,0,60,0,0,0,,
8,175,0,30,0,0,0,,
9,175,0,10,0,0,0,,
5,175,0,-20,0,0,0,,
6,175,0,-50,0,0,0,,
7,175,0,-80,0,0,0,,
8,175,0,-110,0,0,0,,
9,175,0,-130,0,0,0,,
6,-175,0,160,0,0,0,,// 奥崖
7,-135,0,160,0,0,0,,
6,-95,0,160,0,0,0,,
7,-55,0,160,0,0,0,,
7,50,0,160,0,0,0,,
6,90,0,160,0,0,0,,
7,130,0,160,0,0,0,,
6,170,0,160,0,0,0,,
10,0,0,100,0,-90,0
10,10,0,100,0,-90,0
10,20,0,100,0,-90,0
10,-10,0,100,0,-90,0
10,-30,0,100,0,-45,0
10,-20,0,100,0,-90,0
10,-50,0,50,0,180,0
10,-50,0,40,0,180,0
10,-50,0,30,0,180,0
10,-50,0,20,0,180,0
10,-50,0,10,0,180,0
10,-55,0,5,0,-90,0
10,-65,0,5,0,-90,0
10,-75,0,5,0,-90,0
10,-85,0,5,0,-90,0
10,-95,0,5,0,-90,0
