2,-90,0,40,0,0,0
2,-80,0,15,0,0,0
2,-70,0,30,0,0,0
6,-175,0,160,0,0,0,,// 奥崖
7,-135,0,160,0,0,0,,
6,-95,0,160,0,0,0,,
7,-55,0,160,0,0,0,,
7,50,0,160,0,0,0,,
6,90,0,160,0,0,0,,
7,130,0,160,0,0,0,,
6,170,0,160,0,0,0,,